..........
..........
..........
..~~......
.~#.#~....
...##~....
.....#....
....*.....
...^^***..
..*.^^^...
